"parroquiaId","codigo","nombre","no_pobres","pobres","total"
"8","10151","BAÑOS",7326,9441,16767
"14","10152","CUMBE",709,4786,5495
"11","10153","CHAUCHA",94,1193,1287
"12","10154","CHECA (JIDCAY)",888,1841,2729
"13","10155","CHIQUINTAD",1750,3052,4802
"19","10156","LLACAO",2169,3157,5326
"21","10157","MOLLETURO",679,6358,7037
"23","10158","NULTI",885,3424,4309
"24","10159","OCTAVIO CORDERO PALACIOS",389,1874,2263
"25","10160","PACCHA",1522,4923,6445
"26","10161","QUINGEO",332,7106,7438
"28","10162","RICAURTE",11113,7946,19059
"31","10163","SAN JOAQUIN",3018,4389,7407
"33","10164","SANTA ANA",974,4375,5349
"34","10165","SAYAUSI",2112,6232,8344
"35","10166","SIDCAY",1017,2920,3937
"36","10167","SININCAY",5936,9791,15727
"38","10168","TARQUI",1650,8805,10455
"40","10169","TURI",3115,5754,8869
"41","10170","VALLE",8861,15322,24183
"42","10171","VICTORIA DEL PORTETE",518,4722,5240
"47","10250","GIRON",3557,4778,8335
"46","10251","ASUNCION",719,2297,3016
"48","10252","SAN GERARDO",271,799,1070
"51","10350","GUALACEO",10318,10825,21143
"50","10352","DANIEL CORDOVA TORAL",284,1417,1701
"52","10353","JADAN",497,3818,4315
"54","10354","MARIANO MORENO",371,2244,2615
"55","10356","REMIGIO CRESPO TORAL",424,984,1408
"56","10357","SAN JUAN",514,4776,5290
"58","10358","ZHIDMAD",227,2507,2734
"53","10359","LUIS CORDERO VEGA",214,1815,2029
"57","10360","SIMON BOLIVAR",157,968,1125
"61","10450","NABON",1390,8099,9489
"59","10451","COCHAPATA",227,2845,3072
"60","10452","EL PROGRESO",95,1916,2011
"62","10453","LAS NIEVES (CHAYA)",218,1062,1280
"70","10550","PAUTE",4847,4883,9730
"65","10552","BULAN",405,1767,2172
"66","10553","CHICAN",936,2641,3577
"68","10554","EL CABO",691,2624,3315
"69","10556","GUARAINAG",127,712,839
"71","10559","SAN CRISTOBAL",184,2209,2393
"72","10561","TOMEBAMBA",98,1243,1341
"67","10562","DUG-DUG",270,1622,1892
"73","10650","PUCARA",753,7405,8158
"74","10652","SAN RAFAEL DE SHARUG",103,1729,1832
"76","10750","SAN FERNANDO",1360,1861,3221
"75","10751","CHUMBLIN",354,395,749
"79","10850","SANTA ISABEL",4600,6904,11504
"77","10851","ABDON CALDERON",1366,3216,4582
"80","10853","ZHAGLLI",148,2007,2155
"90","10950","SIGSIG",3015,8072,11087
"84","10951","CUCHIL",306,1379,1685
"85","10952","GIMA",660,2224,2884
"86","10953","GUEL",441,903,1344
"87","10954","LUDO",124,3241,3365
"88","10955","SAN BARTOLOME",487,3612,4099
"89","10956","SAN JOSE DE RARANGA",340,2007,2347
"63","11050","OÑA",366,2013,2379
"64","11051","SUSUDEL",240,948,1188
"3","11150","CHORDELEG",3197,3545,6742
"6","11151","PRINCIPAL",418,910,1328
"4","11152","LA UNION",356,1540,1896
"5","11153","LUIS GALARZA ORELLANA",116,1378,1494
"7","11154","SAN MARTIN DE PUZHIO",114,935,1049
"44","11250","EL PAN",586,603,1189
"45","11253","SAN VICENTE",556,1267,1823
"83","11350","SEVILLA DE ORO",911,1322,2233
"81","11351","AMALUZA",125,1023,1148
"82","11352","PALMAS",592,1622,2214
"49","11450","GUACHAPALA",1258,2125,3383
"1","11550","CAMILO PONCE ENRIQUEZ",3967,11426,15393
"2","11551","EL CARMEN DE PIJILI",704,3697,4401
"101","20151","FACUNDO VELA",286,3029,3315
"104","20153","JULIO E. MORENO",85,2863,2948
"105","20155","SALINAS",623,5148,5771
"106","20156","SAN LORENZO",137,1716,1853
"108","20157","SAN SIMON (YACOTO)",304,3876,4180
"109","20158","SANTAFE (SANTA FE)",366,1383,1749
"110","20159","SIMIATUG",125,11103,11228
"107","20160","SAN LUIS DE PAMBIL",1252,4090,5342
"92","20250","CHILLANES",2092,11083,13175
"93","20251","SAN JOSE DEL TAMBO",498,3612,4110
"96","20350","SAN JOSE DE CHIMBO",2883,2734,5617
"94","20351","ASUNCION (ASANCOTO)",348,2481,2829
"95","20353","MAGDALENA (CHAPACOTO)",562,2248,2810
"32","20354","SAN SEBASTIAN",171,882,1053
"98","20355","TELIMBELA",96,3155,3251
"99","20450","ECHEANDIA",3962,8093,12055
"116","20550","SAN MIGUEL",5290,7032,12322
"113","20551","BALSAPAMBA",413,2344,2757
"114","20552","BILOVAN",268,2462,2730
"115","20553","REGULO DE MORA",31,911,942
"564","20554","SAN PABLO",547,4923,5470
"119","20555","SANTIAGO",184,1560,1744
"118","20556","SAN VICENTE",87,1050,1137
"91","20650","CALUMA",4661,8378,13039
"112","20750","LAS NAVES",897,5155,6052
"121","30150","AZOGUES",22486,14889,37375
"123","30151","COJITAMBO",1335,2347,3682
"124","30153","GUAPAN",2399,6436,8835
"125","30154","JAVIER LOYOLA",2125,4576,6701
"126","30155","LUIS CORDERO",1623,2219,3842
"127","30156","PINDILIG",253,1850,2103
"128","30157","RIVERA",90,1452,1542
"130","30158","SAN MIGUEL",636,2924,3560
"131","30160","TADAY",340,1277,1617
"132","30250","BIBLIAN",4820,8796,13616
"134","30251","NAZON",280,2283,2563
"135","30252","SAN FRANCISCO DE SAGEO",532,1185,1717
"136","30253","TURUPAMBA",90,981,1071
"133","30254","JERUSALEN",262,1463,1725
"137","30350","CAÑAR",8993,9137,18130
"138","30351","CHONTAMARCA",488,3646,4134
"139","30352","CHOROCOPTE",925,2151,3076
"141","30353","GENERAL MORALES",91,3308,3399
"142","30354","GUALLETURO",496,3345,3841
"143","30355","HONORATO VASQUEZ",1242,4902,6144
"144","30356","INGAPIRCA",687,7631,8318
"145","30357","JUNCAL",189,1980,2169
"146","30358","SAN ANTONIO",385,1509,1894
"148","30361","ZHUD",193,2175,2368
"147","30362","VENTURA",80,1208,1288
"140","30363","DUCUR",508,3497,4005
"152","30450","LA TRONCAL",14365,27964,42329
"153","30451","MANUEL J. CALLE",818,1937,2755
"154","30452","PANCHO NEGRO",652,8319,8971
"151","30550","EL TAMBO",2971,6457,9428
"149","30650","DELEG",1329,3071,4400
"150","30651","SOLANO",199,1459,1658
"155","30750","SUSCAL",772,4175,4947
"189","40150","TULCAN",39507,19672,59179
"180","40151","EL CARMELO (EL PUN)",500,2263,2763
"183","40153","JULIO ANDRADE (OREJUELA)",2768,6809,9577
"184","40154","MALDONADO",167,1502,1669
"185","40155","PIOTER",201,517,718
"187","40156","TOBAR DONOSO (LA BOCANA)",0,839,839
"188","40157","TUFIÑO",506,1828,2334
"190","40158","URBINA (TAYA)",316,1878,2194
"181","40159","EL CHICAL",241,3162,3403
"186","40161","SANTA MARTHA DE CUBA",593,1763,2356
"156","40250","BOLIVAR",1815,3385,5200
"157","40251","GARCIA MORENO",202,1204,1406
"158","40252","LOS ANDES",365,1895,2260
"159","40253","MONTE OLIVO",296,1388,1684
"161","40254","SAN VICENTE DE PUSIR",148,1896,2044
"160","40255","SAN RAFAEL",252,1489,1741
"163","40350","EL ANGEL",2716,3547,6263
"164","40351","EL GOALTAL",52,761,813
"165","40352","LA LIBERTAD (ALIZO)",916,2578,3494
"166","40353","SAN ISIDRO",1132,1574,2706
"170","40450","MIRA (CHONTAHUASI)",2604,3359,5963
"169","40451","CONCEPCION",166,2637,2803
"167","40452","JIJON Y CAAMAÑO",125,1937,2062
"168","40453","JUAN MONTALVO",176,1132,1308
"172","40551","CRISTOBAL COLON",608,2333,2941
"171","40552","CHITAN DE NAVARRETE",186,431,617
"173","40553","FERNANDEZ SALVADOR",154,1128,1282
"175","40554","LA PAZ",590,2839,3429
"176","40555","PIARTAL",275,865,1140
"178","40650","HUACA",2397,3810,6207
"179","40651","MARISCAL SUCRE",322,1049,1371
"197","50151","ALAQUES (ALAQUEZ)",938,4536,5474
"198","50152","BELISARIO QUEVEDO",736,5612,6348
"200","50153","GUAITACAMA (GUAYTACAMA)",2128,6728,8856
"202","50154","JOSEGUANGO BAJO",483,2330,2813
"205","50156","MULALO",971,7122,8093
"196","50157","11 DE NOVIEMBRE (ILINCHI",130,1858,1988
"206","50158","POALO",109,5598,5707
"208","50159","SAN JUAN DE PASTOCALLE",954,10480,11434
"209","50161","TANICUCHI",2145,10641,12786
"210","50162","TOACASO",536,7133,7669
"194","50250","LA MANA",10943,25051,35994
"193","50251","GUASAGANDA",355,3548,3903
"195","50252","PUCAYACU",292,1762,2054
"211","50350","EL CORAZON",886,5612,6498
"212","50351","MORASPUNGO",1273,11070,12343
"213","50352","PINLLOPATA",15,1015,1030
"214","50353","RAMON CAMPAÑA",3,1991,1994
"219","50450","PUJILI",7353,25968,33321
"215","50451","ANGAMARCA",131,5117,5248
"216","50453","GUANGAJE",2,8023,8025
"217","50455","LA VICTORIA",373,2643,3016
"218","50456","PILALO",50,2590,2640
"220","50457","TINGO",303,3737,4040
"221","50458","ZUMBAHUA",243,12354,12597
"227","50550","SAN MIGUEL",11139,20055,31194
"222","50551","ANTONIO JOSE HOLGUIN",625,2006,2631
"223","50552","CUSUBAMBA",190,7007,7197
"224","50553","MULALILLO",792,5587,6379
"225","50554","MULLIQUINDIL (SANTA ANA)",723,6462,7185
"226","50555","PANSALEO",815,2547,3362
"231","50650","SAQUISILI",3634,9736,13370
"228","50651","CANCHAGUA",133,5322,5455
"229","50652","CHANTILIN",142,893,1035
"230","50653","COCHAPAMBA",53,5370,5423
"236","50750","SIGCHOS",840,7066,7906
"232","50751","CHUGCHILAN",54,7733,7787
"233","50752","ISINLIVI",79,3145,3224
"234","50753","LAS PAMPAS",353,1589,1942
"235","50754","PALO QUEMADO",45,982,1027
"282","60151","CACHA",11,3149,3160
"283","60152","CALPI",1036,5383,6419
"284","60153","CUBIJIES",236,2277,2513
"285","60154","FLORES",24,4522,4546
"286","60155","LICAN",1793,6034,7827
"287","60156","LICTO",356,7449,7805
"290","60157","PUNGALA",289,5662,5951
"291","60158","PUNIN",130,5836,5966
"292","60159","QUIMIAG",231,5019,5250
"293","60160","SAN JUAN",1129,6209,7338
"294","60161","SAN LUIS",3292,8616,11908
"238","60250","ALAUSI",3876,5962,9838
"237","60251","ACHUPALLAS",216,10312,10528
"239","60253","GUASUNTOS",306,2071,2377
"240","60254","HUIGRA",346,2003,2349
"241","60255","MULTITUD",143,1938,2081
"242","60256","PISTISHI (NARIZ DEL DIABLO)",13,332,345
"243","60257","PUMALLACTA (PUMAL-LACTA)",43,862,905
"244","60258","SEVILLA",104,699,803
"245","60259","SIBAMBE",245,3620,3865
"246","60260","TIXAN",329,10240,10569
"253","60350","VILLA LA UNION",2523,15941,18464
"254","60351","CAÑI",13,949,962
"255","60352","COLUMBE",380,15474,15854
"256","60353","JUAN DE VELASCO (PANGOR)",45,3847,3892
"257","60354","SANTIAGO DE QUITO",57,5609,5666
"247","60450","CHAMBO",3537,8244,11781
"249","60550","CHUNCHI",2526,4754,7280
"248","60551","CAPZOL",34,865,899
"250","60552","COMPUD",42,836,878
"251","60553","GONZOL",231,1488,1719
"252","60554","LLAGOS",292,1480,1772
"261","60650","GUAMOTE",1663,22942,24605
"260","60651","CEBADAS",208,7988,8196
"262","60652","PALMIRA",148,12149,12297
"264","60751","GUANANDO",24,317,341
"265","60752","ILAPO",83,1579,1662
"267","60753","LA PROVIDENCIA",13,540,553
"268","60754","SAN ANDRES",1953,11500,13453
"269","60755","SAN GERARDO DE PACAICAGUAN",387,2052,2439
"270","60756","SAN ISIDRO DE PATULU",231,4513,4744
"271","60757","SAN JOSE DEL CHAZO",65,972,1037
"272","60758","SANTA FE DE GALAN",136,1533,1669
"273","60759","VALPARAISO",0,404,404
"274","60850","PALLATANGA",1735,9771,11506
"279","60950","PENIPE",732,1222,1954
"276","60951","EL ALTAR",254,1011,1265
"278","60952","MATUS",248,735,983
"280","60953","PUELA",88,534,622
"281","60954","SAN ANTONIO DE BAYUSHIG",320,781,1101
"277","60955","LA CANDELARIA",73,402,475
"275","60956","BILBAO",18,178,196
"259","61050","CUMANDA",3984,8855,12839
"333","70150","MACHALA",104049,134023,238072
"329","70152","EL RETIRO",257,3918,4175
"298","70250","ARENILLAS",7034,13690,20724
"300","70251","CHACRAS",28,1505,1533
"302","70254","PALMALES",303,2936,3239
"299","70255","CARCABON",22,714,736
"306","70350","PACCHA",1168,1107,2275
"303","70351","AYAPAMBA",519,865,1384
"304","70352","CORDONCILLO",365,638,1003
"305","70353","MILAGRO",157,315,472
"177","70354","SAN JOSE",75,290,365
"308","70355","CERRO AZUL",72,216,288
"309","70450","BALSAS",1786,3828,5614
"310","70451","BELLAMARIA",290,923,1213
"311","70550","CHILLA",398,2083,2481
"313","70650","EL GUABO",9545,20167,29712
"312","70651","BARBONES (SUCRE)",986,4667,5653
"314","70652","LA IBERIA",866,2833,3699
"316","70653","TENDALES",228,4796,5024
"315","70654","RIO BONITO",1130,4334,5464
"336","70850","MARCABELI",2424,2705,5129
"335","70851","EL INGENIO",110,142,252
"338","70951","BUENAVISTA",1361,5180,6541
"340","70952","CASACAY",514,1886,2400
"341","70953","LA PEAÑA",837,2746,3583
"344","70954","PROGRESO",681,3285,3966
"346","70955","UZHCURRUMI",92,824,916
"339","70956","CAÑA QUEMADA",282,1551,1833
"352","71050","PIÑAS",9507,7794,17301
"347","71051","CAPIRO",381,1479,1860
"348","71052","LA BOCANA",225,1140,1365
"350","71053","MOROMORO",299,1071,1370
"351","71054","PIEDRAS",134,435,569
"354","71055","SAN ROQUE",213,650,863
"355","71056","SARACAY",582,1928,2510
"358","71150","PORTOVELO",4666,5240,9906
"356","71151","CURTINCAPA",77,433,510
"357","71152","MORALES",80,587,667
"359","71153","SALATI",86,940,1026
"369","71250","SANTA ROSA",25953,26411,52364
"362","71251","BELLAVISTA",955,1861,2816
"330","71252","JAMBELI",122,1588,1710
"365","71253","LA AVANZADA",788,1125,1913
"368","71254","SAN ANTONIO",155,1906,2061
"370","71255","TORATA",772,1169,1941
"371","71256","VICTORIA",510,2660,3170
"361","71257","BELLAMARIA",348,1836,2184
"381","71350","ZARUMA",6698,3756,10454
"372","71351","ABAÑIN",16,1668,1684
"373","71352","ARCAPAMBA",339,647,986
"374","71353","GUANAZAN",64,2981,3045
"375","71354","GUIZHAGUIÑA",125,1562,1687
"376","71355","HUERTAS",717,1273,1990
"377","71356","MALVAS",418,750,1168
"378","71357","MULUNCAY GRANDE",312,475,787
"380","71358","SINSAO",98,1238,1336
"379","71359","SALVIAS",98,650,748
"633","71450","LA VICTORIA",917,1679,2596
"323","71451","LA LIBERTAD",105,690,795
"318","71452","EL PARAISO",227,534,761
"326","71453","SAN ISIDRO",93,505,598
"408","80150","ESMERALDAS",77614,81798,159412
"405","80152","CAMARONES",136,2676,2812
"407","80153","CRNEL. CARLOS CONCHA TORRES",38,2316,2354
"406","80154","CHINCA",194,4354,4548
"410","80159","MAJUA",31,2502,2533
"411","80163","SAN MATEO",549,5140,5689
"413","80165","TABIAZO",73,2582,2655
"414","80166","TACHINA",862,3117,3979
"415","80168","VUELTA LARGA",856,2113,2969
"402","80250","VALDEZ (LIMONES)",555,5616,6171
"387","80251","ANCHAYACU",0,2527,2527
"388","80252","ATAHUALPA",0,1442,1442
"389","80253","BORBON",1212,6444,7656
"391","80254","LA TOLA",0,4362,4362
"392","80255","LUIS VARGAS TORRES",2,341,343
"289","80256","MALDONADO",196,1642,1838
"394","80257","PAMPANAL DE BOLIVAR",0,1118,1118
"395","80258","SAN FRANCISCO DE ONZOLE",0,1430,1430
"398","80259","SANTO DOMINGO DE ONZOLE",0,1934,1934
"399","80260","SELVA ALEGRE",72,1092,1164
"400","80261","TELEMBI",0,5639,5639
"390","80262","COLON ELOY DEL MARIA",41,1359,1400
"396","80263","SAN JOSE DE CAYAPAS",0,1513,1513
"401","80264","TIMBIRE",100,932,1032
"419","80350","MUISNE",338,8537,8875
"337","80351","BOLIVAR",0,1039,1039
"417","80352","DAULE",35,2111,2146
"418","80353","GALERA",55,1663,1718
"420","80354","QUINGUE (OLMEDO PERDOMO",34,539,573
"421","80355","SALIMA",0,1116,1116
"129","80356","SAN FRANCISCO",23,2776,2799
"423","80357","SAN GREGORIO",6,5907,5913
"424","80358","SAN JOSE DE CHAMANGA",0,4254,4254
"429","80450","ROSA ZARATE (QUININDE)",6447,60682,67129
"426","80451","CUBE",42,7539,7581
"425","80452","CHURA (CHANCAMA)",0,4733,4733
"428","80453","MALIMPIA",188,17559,17747
"430","80454","VICHE",469,4793,5262
"383","80455","LA UNION",3851,15989,19840
"445","80550","SAN LORENZO",5683,19186,24869
"438","80551","ALTO TAMBO",36,1813,1849
"439","80552","ANCON (PICHANGAL)",25,1785,1810
"440","80553","CALDERON",69,559,628
"441","80554","CARONDELET",75,1626,1701
"437","80555","5 DE JUNIO",8,408,416
"442","80556","CONCEPCION",67,2275,2342
"443","80557","MATAJE",16,1441,1457
"444","80558","SAN JAVIER DE CACHAVI",63,601,664
"446","80559","SANTA RITA",163,1469,1632
"447","80560","TAMBILLO",25,1674,1699
"448","80561","TULULBI",254,2035,2289
"449","80562","URBINA",5,747,752
"382","80650","ATACAMES",4077,12523,16600
"427","80651","LA UNION",6,2534,2540
"384","80652","SUA",559,2842,3401
"385","80653","TONCHIGUE",1232,6712,7944
"386","80654","TONSUPA",2423,8204,10627
"431","80751","CHONTADURO",17,3205,3222
"432","80752","CHUMUNDE",1,3511,3512
"433","80753","LAGARTO",89,5576,5665
"434","80754","MONTALVO",133,3854,3987
"436","80755","ROCAFUERTE",4,5481,5485
"462","90152","JUAN GOMEZ RENDON (PROGR",2447,9408,11855
"464","90153","MORRO",783,4190,4973
"466","90156","POSORJA",6477,17508,23985
"467","90157","PUNA",192,6537,6729
"472","90158","TENGUEL",2064,9706,11770
"478","90250","ALFREDO BAQUERIZO MORENO",2605,22502,25107
"479","90350","BALAO",3032,17294,20326
"480","90450","BALZAR",5017,48734,53751
"481","90550","COLIMES",1612,15639,17251
"482","90551","SAN JACINTO",78,6028,6106
"484","90650","DAULE",28979,57827,86806
"486","90652","JUAN BAUTISTA AGUIRRE",0,5502,5502
"485","90653","LAUREL",613,9251,9864
"489","90654","LIMONAL",234,8534,8768
"488","90656","LOS LOJAS",23,8637,8660
"456","90750","ELOY ALFARO (DURAN)",75256,158588,233844
"493","90850","VELASCO IBARRA",5825,41570,47395
"492","90851","GUAYAS (PUEBLO NUEVO)",408,17086,17494
"491","90852","EL ROSARIO",317,8886,9203
"494","90950","EL TRIUNFO",8135,36396,44531
"500","91050","MILAGRO",47393,96620,144013
"498","91051","CHOBO",769,4643,5412
"499","91053","MARISCAL SUCRE (HUAQUES)",93,5266,5359
"501","91054","ROBERTO ASTUDILLO",272,10543,10815
"503","91150","NARANJAL",13526,25827,39353
"502","91151","JESUS MARIA",823,5571,6394
"504","91152","SAN CARLOS",1030,5460,6490
"505","91153","SANTA ROSA DE FLANDES",569,4817,5386
"506","91154","TAURA",361,9738,10099
"507","91250","NARANJITO",11515,25426,36941
"509","91350","PALESTINA",2770,13229,15999
"510","91450","PEDRO CARBO",2383,28849,31232
"512","91451","VALLE DE LA VIRGEN",34,5183,5217
"511","91452","SABANILLA",106,6783,6889
"476","91650","SAMBORONDON",31476,19886,51362
"477","91651","TARIFA",918,15022,15940
"521","91850","SANTA LUCIA",3218,35620,38838
"518","91950","EL SALITRE (LAS RAMAS)",2762,25289,28051
"515","91951","GENERAL VERNAZA",92,9406,9498
"520","91952","LA VICTORIA (ÑAUZA)",169,6292,6461
"516","91953","JUNQUILLAL",271,13030,13301
"526","92050","YAGUACHI NUEVO",7018,19396,26414
"524","92053","GRAL. PEDRO J. MONTERO",861,7331,8192
"527","92055","YAGUACHI VIEJO (CONE)",455,11493,11948
"525","92056","VIRGEN DE FATIMA",2922,11016,13938
"474","92150","GENERAL VILLAMIL",13027,28564,41591
"523","92250","SIMON BOLIVAR",1729,12800,14529
"522","92251","CRNEL.LORENZO DE GARAICOA",725,10160,10885
"483","92350","CORONEL MARCELINO MARIDUEÑA",2856,9056,11912
"497","92450","LOMAS DE SARGENTILLO",2116,16204,18320
"508","92550","NARCISA DE JESUS",4949,14556,19505
"495","92750","GENERAL ANTONIO ELIZALDE",3323,7280,10603
"496","92850","ISIDRO AYORA",599,10253,10852
"544","100151","AMBUQUI",797,4654,5451
"545","100152","ANGOCHAGUA",255,3004,3259
"547","100153","CAROLINA",111,2620,2731
"550","100154","LA ESPERANZA",1488,5604,7092
"551","100155","LITA",332,3006,3338
"553","100156","SALINAS",812,924,1736
"554","100157","SAN ANTONIO",9142,8296,17438
"529","100250","ATUNTAQUI",13620,9620,23240
"530","100251","IMBAYA",136,1140,1276
"555","100252","SAN FRANCISCO DE NATABUE",2798,2842,5640
"532","100253","SAN JOSE DE CHALTURA",1194,1901,3095
"533","100254","SAN ROQUE",2575,7500,10075
"535","100351","APUELA",217,1604,1821
"461","100352","GARCIA MORENO",218,4827,5045
"537","100353","IMANTAG",297,4631,4928
"538","100354","PEÑAHERRERA",250,1390,1640
"539","100355","PLAZA GUTIERREZ",32,464,496
"540","100356","QUIROGA",2180,4248,6428
"534","100357","6 DE JULIO DE CUELLAJE",245,1533,1778
"543","100358","VACAS GALINDO (EL CHURO)",60,638,698
"556","100451","DR. MIGUEL EGAS CABEZAS",895,3975,4870
"557","100452","EUGENIO ESPEJO (CALPAQUI)",909,6437,7346
"174","100453","GONZALEZ SUAREZ",926,4695,5621
"560","100454","PATAQUI",9,260,269
"561","100455","SAN JOSE DE QUICHINCHE",652,7809,8461
"562","100456","SAN JUAN DE ILUMAN",1420,7125,8545
"811","100457","SAN PABLO",2764,7095,9859
"565","100458","SAN RAFAEL",728,4685,5413
"566","100459","SELVA ALEGRE",121,1470,1591
"569","100550","PIMAMPIRO",3343,5707,9050
"567","100551","CHUGA",2,1078,1080
"568","100552","MARIANO ACOSTA",208,1336,1544
"570","100553","SAN FRANCISCO DE SIGSIPA",159,1110,1269
"576","100650","URCUQUI",1868,3310,5178
"571","100651","CAHUASQUI",458,1347,1805
"572","100652","LA MERCED DE BUENOS AIRES",256,1637,1893
"573","100653","PABLO ARENAS",542,1552,2094
"574","100654","SAN BLAS",736,2272,3008
"575","100655","TUMBABIRO",426,1198,1624
"613","110151","CHANTACO",95,1082,1177
"614","110152","CHUQUIRIBAMBA",106,2352,2458
"615","110153","EL CISNE",456,1150,1606
"618","110154","GUALEL",117,1943,2060
"619","110155","JIMBILLA",65,1049,1114
"620","110156","MALACATOS (VALLADOLID)",1562,5457,7019
"623","110157","SAN LUCAS",158,4510,4668
"624","110158","SAN PEDRO DE VILCABAMBA",420,862,1282
"626","110159","SANTIAGO",103,1270,1373
"628","110160","TAQUIL (MIGUEL RIOFRIO)",114,3540,3654
"629","110161","VILCABAMBA (VICTORIA)",1897,2731,4628
"630","110162","YANGANA (ARSENIO CASTILLO)",309,1107,1416
"622","110163","QUINARA",184,1200,1384
"577","110250","CARIAMANGA",8066,12687,20753
"579","110251","COLAISACA",20,1834,1854
"580","110252","EL LUCERO",168,1851,2019
"583","110253","UTUANA",20,1317,1337
"582","110254","SANGILLIN",16,1652,1668
"584","110350","CATAMAYO (LA TOMA)",9882,13256,23138
"585","110351","EL TAMBO",278,4350,4628
"586","110352","GUAYQUICHUMA",35,348,383
"588","110353","SAN PEDRO DE LA BENDITA",808,772,1580
"589","110354","ZAMBI",67,513,580
"590","110450","CELICA",2550,4326,6876
"591","110451","CRUZPAMBA",168,921,1089
"593","110455","POZUL (SAN JUAN DE POZUL",295,2740,3035
"592","110456","SABANILLA",293,2131,2424
"594","110457","TNTE. MAXIMILIANO RODRIG",96,477,573
"597","110550","CHAGUARPAMBA",681,2752,3433
"596","110551","BUENAVISTA",213,1000,1213
"598","110552","EL ROSARIO",25,470,495
"599","110553","SANTA RUFINA",81,1127,1208
"595","110554","AMARILLOS",43,619,662
"601","110650","AMALUZA",841,2533,3374
"602","110651","BELLAVISTA",18,2314,2332
"605","110652","JIMBURA",114,2202,2316
"606","110653","SANTA TERESITA",62,1694,1756
"600","110654","27 DE ABRIL",166,1896,2062
"604","110655","EL INGENIO",215,1594,1809
"603","110656","EL AIRO",25,972,997
"608","110750","GONZANAMA",1067,1437,2504
"607","110751","CHANGAIMINA (LA LIBERTAD",395,2353,2748
"609","110753","NAMBACOLA",201,4314,4515
"610","110754","PURUNUMA (EGUIGUREN)",27,729,756
"611","110756","SACAPALCA",132,2033,2165
"634","110850","MACARA",6543,8738,15281
"632","110851","LARAMA",17,1063,1080
"629","110852","LA VICTORIA",88,1469,1557
"635","110853","SABIANGO (LA CAPILLA)",199,439,638
"640","110950","CATACOCHA",3494,8591,12085
"638","110951","CANGONAMA",26,1245,1271
"641","110952","GUACHANAMA",50,2551,2601
"642","110954","LAURO GUERRERO",68,1757,1825
"644","110956","ORIANGA",24,1739,1763
"645","110957","SAN ANTONIO",38,1052,1090
"639","110958","CASANGA",148,1635,1783
"646","110959","YAMANA",150,1091,1241
"651","111050","ALAMOR",2708,5487,8195
"652","111051","CIANO",180,1246,1426
"653","111052","EL ARENAL",114,867,981
"654","111053","EL LIMO (MARIANA DE JESUS)",196,2161,2357
"655","111054","MERCADILLO",206,968,1174
"656","111055","VICENTINO",105,1160,1265
"667","111150","SARAGURO",2403,6593,8996
"660","111151","EL PARAISO DE CELEN",103,2649,2752
"661","111152","EL TABLON",27,885,912
"662","111153","LLUZHAPA",77,1628,1705
"663","111154","MANU",293,2367,2660
"664","111155","SAN ANTONIO DE QUMBE",30,1114,1144
"665","111156","SAN PABLO DE TENTA",137,3526,3663
"666","111157","SAN SEBASTIAN DE YULUC",108,864,972
"668","111158","SELVA ALEGRE",107,1806,1913
"670","111159","URDANETA (PAQUISHAPA)",379,3383,3762
"669","111160","SUMAYPAMBA",301,1283,1584
"672","111250","SOZORANGA",527,3228,3755
"671","111251","NUEVA FATIMA",58,843,901
"673","111252","TACAMOROS",126,2675,2801
"680","111350","ZAPOTILLO",1064,3117,4181
"675","111351","CAZADEROS",47,1121,1168
"676","111352","GARZAREAL",31,1743,1774
"677","111353","LIMONES",59,1347,1406
"679","111354","PALETILLAS",99,2524,2623
"674","111355","BOLASPAMBA",12,1074,1086
"650","111450","PINDAL",1081,4568,5649
"648","111451","CHAQUINAL",3,1084,1087
"647","111452","12 DE DICIEMBRE",113,1776,1889
"658","111550","QUILANGA",474,2231,2705
"657","111551","FUNDOCHAMBA",76,277,353
"659","111552","SAN ANTONIO DE LAS ARADAS",119,1140,1259
"637","111650","OLMEDO",480,3714,4194
"636","111651","LA TINGUE",12,656,668
"685","120152","CARACOL",252,4846,5098
"689","120153","FEBRES CORDERO (LAS JUNTAS)",1898,16016,17914
"691","120154","PIMOCHA",1234,19764,20998
"690","120155","LA UNION",974,11714,12688
"681","120250","BABA",1857,16946,18803
"682","120251","GUARE",262,11177,11439
"683","120252","ISLA DE BEJUCAL",699,8684,9383
"696","120350","MONTALVO",5440,18508,23948
"698","120450","PUEBLOVIEJO",2887,10409,13296
"699","120451","PUERTO PECHICHE",122,4545,4667
"700","120452","SAN JUAN",2952,15450,18402
"705","120550","QUEVEDO",48277,108953,157230
"707","120553","SAN CARLOS",1282,8734,10016
"703","120555","LA ESPERANZA",599,4238,4837
"713","120650","CATARAMA",1745,6814,8559
"714","120651","RICAURTE",2010,18623,20633
"719","120750","VENTANAS",9589,35832,45421
"720","120752","ZAPOTAL",855,20044,20899
"722","120850","VINCES",11280,43831,55111
"721","120851","ANTONIO SOTOMAYOR",634,15657,16291
"697","120950","PALENQUE",1778,20484,22262
"693","121050","SAN JACINTO DE BUENA FE",12994,37259,50253
"692","121051","PATRICIA PILAR",2071,10157,12228
"715","121150","VALENCIA",4174,38198,42372
"694","121250","MOCACHE",3724,34584,38308
"712","121350","QUINSALOMA",1838,14592,16430
"808","130150","PORTOVIEJO",93906,126608,220514
"800","130151","ABDON CALDERON",551,13600,14151
"801","130152","ALHAJUELA (BAJO GRANDE)",121,3633,3754
"805","130153","CRUCITA",1084,12939,14023
"809","130154","PUEBLO NUEVO",55,3101,3156
"810","130155","RIOCHICO (RIO CHICO)",221,11084,11305
"812","130156","SAN PLACIDO",221,7449,7670
"803","130157","CHIRIJOS",0,2362,2362
"723","130250","CALCETA",3811,29434,33245
"724","130251","MEMBRILLO",127,3423,3550
"725","130252","QUIROGA",221,2762,2983
"729","130350","CHONE",22657,51592,74249
"726","130351","BOYACA",102,4397,4499
"727","130352","CANUTO",364,9985,10349
"730","130353","CONVENTO",15,6560,6575
"728","130354","CHIBUNGA",0,6326,6326
"731","130355","ELOY ALFARO",150,7670,7820
"732","130356","RICAURTE",350,7539,7889
"733","130357","SAN ANTONIO",260,7754,8014
"736","130450","EL CARMEN",17075,60178,77253
"740","130451","WILFRIDO LOOR MOREIRA",58,4509,4567
"738","130452","SAN PEDRO DE SUMA",139,6550,6689
"741","130550","FLAVIO ALFARO",1220,17311,18531
"742","130551","SAN FRANCISCO DE NOVILLO",56,2723,2779
"743","130552","ZAPALLO",135,3553,3688
"771","130650","JIPIJAPA",11090,37555,48645
"768","130651","AMERICA",69,2991,3060
"770","130652","EL ANEGADO",45,6814,6859
"772","130653","JULCUY",16,2159,2175
"773","130654","LA UNION",13,1921,1934
"775","130656","MEMBRILLAL",0,1003,1003
"776","130657","PEDRO PABLO GOMEZ",122,3441,3563
"777","130658","PUERTO DE CAYO",405,2985,3390
"745","130750","JUNIN",2640,16272,18912
"781","130850","MANTA",100951,117479,218430
"782","130851","SAN LORENZO",12,2616,2628
"784","130852","SANTA MARIANITA",0,2705,2705
"791","130950","MONTECRISTI",6747,60951,67698
"789","130952","LA PILA",0,2452,2452
"797","131050","PAJAN",1484,10755,12239
"793","131051","CAMPOZANO",83,8424,8507
"794","131052","CASCOL",212,6820,7032
"795","131053","GUALE",104,3823,3927
"796","131054","LASCANO",132,5043,5175
"751","131150","PICHINCHA",1740,15670,17410
"750","131151","BARRAGANETE",92,7468,7560
"752","131152","SAN SEBASTIAN",263,4977,5240
"753","131250","ROCAFUERTE",7208,26082,33290
"458","131351","AYACUCHO",1454,5949,7403
"818","131352","HONORATO VASQUEZ",363,5515,5878
"819","131353","LA UNION",0,6453,6453
"821","131355","SAN PABLO",22,5281,5303
"756","131450","BAHIA DE CARAQUEZ",6681,18901,25582
"757","131453","CHARAPOTO",1405,18610,20015
"759","131457","SAN ISIDRO",1484,9478,10962
"762","131550","TOSAGUA",4888,23172,28060
"761","131551","BACHILLERO",354,3426,3780
"760","131552","ANGEL PEDRO GILER",694,5555,6249
"766","131650","SUCRE",1134,12250,13384
"764","131651","BELLAVISTA",161,4752,4913
"765","131652","NOBOA",133,6415,6548
"763","131653","ARQ. SIXTO DURAN BALLEN",31,3921,3952
"749","131750","PEDERNALES",3178,30266,33444
"748","131751","COJIMIES",190,13496,13686
"746","131752","10 DE AGOSTO",45,5162,5207
"747","131753","ATAHUALPA",44,2518,2562
"792","131850","OLMEDO",255,9588,9843
"815","131950","PUERTO LOPEZ",995,9772,10767
"814","131951","MACHALILLA",0,4984,4984
"816","131952","SALANGO",393,4104,4497
"744","132050","JAMA",2240,20757,22997
"767","132150","JARAMIJO",3689,14511,18200
"755","132250","SAN VICENTE",3039,12024,15063
"754","132251","CANOA",106,6634,6740
"847","140150","MACAS",11575,6873,18448
"844","140151","ALSHI",60,321,381
"846","140153","GENERAL PROAÑO",664,1901,2565
"849","140156","SAN ISIDRO",188,585,773
"850","140157","SEVILLA DON BOSCO",527,12770,13297
"851","140158","SINAI",177,586,763
"852","140160","ZUÑA (ZUÑAC)",0,223,223
"845","140162","CUCHAENTZA",119,1663,1782
"848","140164","RIO BLANCO",461,1520,1981
"828","140250","GUALAQUIZA",4448,4358,8806
"823","140251","AMAZONAS (ROSARIO DE CUYES)",27,385,412
"824","140252","BERMEJOS",31,192,223
"825","140253","BOMBOIZA",96,4407,4503
"826","140254","CHIGUINDA",100,452,552
"831","140255","EL ROSARIO",135,473,608
"830","140256","NUEVA TARQUI",124,387,511
"832","140257","SAN MIGUEL DE CUYES",10,173,183
"827","140258","EL IDEAL",49,772,821
"835","140350","GENERAL LEONIDAS PLAZA G.",1546,2397,3943
"836","140351","INDANZA",324,905,1229
"837","140353","SAN ANTONIO",10,2147,2157
"838","140356","SAN MIGUEL DE CONCHAY",1,404,405
"839","140357","SANTA SUSANA DE CHIVIAZA",72,700,772
"840","140358","YUNGANZA",36,1008,1044
"857","140450","PALORA (METZERA)",2051,1867,3918
"855","140451","ARAPICOS",17,465,482
"856","140452","CUMANDA",7,338,345
"858","140454","SANGAY",148,1022,1170
"854","140455","16 DE AGOSTO",87,900,987
"881","140550","SANTIAGO DE MENDEZ",1534,1437,2971
"865","140551","COPAL",62,418,480
"864","140552","CHUPIANZA",35,432,467
"867","140553","PATUCA",241,1564,1805
"869","140554","SAN LUIS DE EL ACHO",74,543,617
"870","140556","TAYUZA",362,1144,1506
"868","140557","SAN FRANCISCO DE CHINIMB",158,919,1077
"874","140650","SUCUA",5607,6881,12488
"871","140651","ASUNCION",49,1851,1900
"872","140652","HUAMBI",779,2098,2877
"873","140655","SANTA MARIANITA DE JESUS",210,686,896
"834","140750","HUAMBOYA",347,2169,2516
"833","140751","CHIGUAZA",50,5830,5880
"862","140850","SAN JUAN BOSCO",989,1139,2128
"859","140851","PAN DE AZUCAR",10,255,265
"860","140852","SAN CARLOS DE LIMON",16,761,777
"861","140853","SAN JACINTO DE WAKAMBEIS",10,194,204
"863","140854","SANTIAGO DE PANANZA",22,447,469
"878","140950","TAISHA",233,5435,5668
"875","140951","HUASAGA",7,1502,1509
"876","140952","MACUMA",3,3882,3885
"879","140953","TUTINENTZA",0,4634,4634
"877","140954","PUMPUENTSA",0,2379,2379
"841","141050","LOGROÑO",699,1350,2049
"843","141051","YAUPI",18,1759,1777
"842","141052","SHIMPIS",2,1891,1893
"853","141150","PABLO VI",455,1365,1820
"880","141251","SAN JOSE DE MORONA",8,2187,2195
"906","150150","TENA",12452,20680,33132
"899","150151","AHUANO",113,5336,5449
"900","150153","CHONTAPUNTA",10,6508,6518
"901","150154","PANO",90,1302,1392
"902","150155","PUERTO MISAHUALLI",150,4904,5054
"903","150156","PUERTO NAPO",501,4848,5349
"905","150157","TALAG",98,2670,2768
"882","150350","ARCHIDONA",2559,8939,11498
"883","150352","COTUNDO",271,8064,8335
"885","150354","SAN PABLO DE USHPAYACU",9,4895,4904
"887","150450","EL CHACO",2113,2614,4727
"888","150451","GONZALO DIAZ DE PINEDA",76,459,535
"889","150452","LINARES",23,186,209
"890","150453","OYACACHI",131,484,615
"891","150454","SANTA ROSA",252,986,1238
"892","150455","SARDINAS",132,405,537
"893","150750","BAEZA",1169,774,1943
"894","150751","COSANGA",43,462,505
"895","150752","CUYUJA",101,513,614
"896","150753","PAPALLACTA",170,525,695
"897","150754","SAN FRANCISCO DE BORJA",728,1415,2143
"898","150756","SUMACO",0,39,39
"886","150950","CARLOS JULIO AROSEMENA TOLA",575,3053,3628
"918","160150","PUYO",18781,17195,35976
"913","160152","CANELOS",0,2142,2142
"912","160154","DIEZ DE AGOSTO",69,1075,1144
"915","160155","FATIMA",145,708,853
"916","160156","MONTALVO (ANDOAS)",2,3599,3601
"917","160157","POMONA",14,211,225
"919","160158","RIO CORRIENTES",0,235,235
"920","160159","RIO TIGRE",0,656,656
"925","160161","SARAYACU",1,2554,2555
"813","160162","SIMON BOLIVAR",54,5621,5675
"922","160163","TARQUI",528,3290,3818
"923","160164","TENIENTE HUGO ORTIZ",1,1047,1048
"924","160165","VERACRUZ (INDILLAMA)",333,1418,1751
"914","160166","EL TRIUNFO",59,1256,1315
"910","160250","MERA",660,856,1516
"909","160251","MADRE TIERRA",63,1506,1569
"911","160252","SHELL",3296,4565,7861
"927","160350","SANTA CLARA",550,2275,2825
"307","160351","SAN JOSE",24,711,735
"907","160450","ARAJUNO",274,3527,3801
"908","160451","CURARAY",4,2681,2685
"960","170151","ALANGASI",15753,8330,24083
"961","170152","AMAGUAÑA",14682,16285,30967
"962","170153","ATAHUALPA (HABASPAMBA)",615,1268,1883
"963","170154","CALACALI",1836,2053,3889
"964","170155","CALDERON (CARAPUNGO)",108721,42138,150859
"967","170156","CONOCOTO",58865,22486,81351
"968","170157","CUMBAYA",23885,7328,31213
"965","170158","CHAVEZPAMBA",268,532,800
"966","170159","CHECA (CHILPA)",2692,6246,8938
"986","170160","EL QUINCHE",7329,8637,15966
"969","170161","GUALEA",275,1746,2021
"970","170162","GUANGOPOLO",1212,1820,3032
"971","170163","GUAYLLABAMBA",6498,9669,16167
"972","170164","LA MERCED",3286,5071,8357
"973","170165","LLANO CHICO",5354,5249,10603
"974","170166","LLOA",488,980,1468
"975","170168","NANEGAL",606,2022,2628
"976","170169","NANEGALITO",939,2074,3013
"977","170170","NAYON",10687,4804,15491
"978","170171","NONO",212,1518,1730
"979","170172","PACTO",812,3983,4795
"980","170174","PERUCHO",313,453,766
"981","170175","PIFO",5971,10608,16579
"982","170176","PINTAG",5453,12407,17860
"983","170177","POMASQUI",21314,7319,28633
"984","170178","PUELLARO",1566,3884,5450
"985","170179","PUEMBO",7479,6062,13541
"987","170180","SAN ANTONIO",21194,10994,32188
"988","170181","SAN JOSE DE MINAS",1690,5543,7233
"989","170183","TABABELA",1319,1478,2797
"990","170184","TUMBACO",29006,20629,49635
"991","170185","YARUQUI",6269,11420,17689
"992","170186","ZAMBIZA",2070,1932,4002
"995","170250","CAYAMBE",23876,26648,50524
"993","170251","ASCAZUBI",1885,3162,5047
"994","170252","CANGAHUA",797,15428,16225
"997","170253","OLMEDO (PESILLO)",739,6027,6766
"998","170254","OTON",197,2568,2765
"1000","170255","SANTA ROSA DE CUZUBAMBA",762,3339,4101
"1006","170350","MACHACHI",16230,11247,27477
"1001","170351","ALOAG",3481,5686,9167
"1002","170352","ALOASI",4085,5545,9630
"1005","170353","CUTUGLAHUA",2018,14722,16740
"1003","170354","EL CHAUPI",507,948,1455
"1004","170355","MANUEL CORNEJO ASTORGA",602,3053,3655
"1007","170356","TAMBILLO",4141,4161,8302
"1008","170357","UYUMBICHO",2727,1872,4599
"1011","170450","TABACUNDO",6235,10110,16345
"1009","170451","LA ESPERANZA",1147,2833,3980
"1010","170452","MALCHINGUI",1363,3259,4622
"1012","170453","TOCACHI",255,1730,1985
"1013","170454","TUPIGACHI",297,5875,6172
"1021","170550","SANGOLQUI",57104,23641,80745
"1016","170551","COTOGCHOA",1310,2619,3929
"941","170552","RUMIPAMBA",10,765,775
"1023","170750","SAN MIGUEL DE LOS BANCOS",3058,10458,13516
"1022","170751","MINDO",1082,2514,3596
"1014","170850","PEDRO VICENTE MALDONADO",3460,9432,12892
"1015","170950","PUERTO QUITO",1327,19108,20435
"1024","180151","AMBATILLO",824,4418,5242
"1025","180152","ATAHUALPA (CHISALATA)",5502,4643,10145
"1027","180153","AUGUSTO N. MARTINEZ",1703,6485,8188
"1029","180154","CONSTANTINO FERNANDEZ",200,2334,2534
"1032","180155","HUACHI GRANDE",3063,7460,10523
"1034","180156","IZAMBA",7125,7267,14392
"1035","180157","JUAN BENIGNO VELA",855,6580,7435
"1040","180159","PASA",408,6086,6494
"1041","180160","PICAIGUA",1727,6542,8269
"1042","180161","PILAGUIN (PILAHUIN)",595,11523,12118
"1044","180162","QUISAPINCHA (QUIZAPINCHA)",1877,11055,12932
"1045","180163","SAN BARTOLOME DE PINLLOG",3592,5443,9035
"1046","180164","SAN FERNANDO",173,2317,2490
"1048","180165","SANTA ROSA",2912,18066,20978
"1049","180166","TOTORAS",1427,5381,6808
"1030","180167","CUNCHIBAMBA",657,3809,4466
"1050","180168","UNAMUNCHO",1014,3658,4672
"1051","180250","BAÑOS",8946,5151,14097
"1052","180251","LLIGUA",11,269,280
"1053","180252","RIO NEGRO",484,760,1244
"1054","180253","RIO VERDE",296,980,1276
"1055","180254","ULBA",1032,1494,2526
"1056","180350","CEVALLOS",3612,4520,8132
"1057","180450","MOCHA",1884,3601,5485
"1058","180451","PINGUILI",227,1045,1272
"1061","180550","PATATE",2851,5258,8109
"1059","180551","EL TRIUNFO",224,1354,1578
"1060","180552","LOS ANDES",210,1181,1391
"1062","180553","SUCRE",230,2139,2369
"1082","180650","QUERO",2338,11879,14217
"1018","180651","RUMIPAMBA",211,2753,2964
"1084","180652","YANAYACU - MOCHAPATA",427,1551,1978
"1070","180750","PELILEO",8628,15842,24470
"1063","180751","BENITEZ (PACHANLICA)",256,1927,2183
"1064","180752","BOLIVAR",572,2137,2709
"1066","180753","COTALO",455,1396,1851
"1065","180754","CHIQUICHA",49,2392,2441
"1067","180755","EL ROSARIO (RUMICHACA)",91,2539,2630
"1068","180756","GARCIA MORENO (CHUMAQUI)",1372,4985,6357
"1069","180757","GUAMBALO (HUAMBALO)",1818,6036,7854
"1072","180758","SALASACA",424,5443,5867
"1077","180850","PILLARO",6678,6600,13278
"1073","180851","BAQUERIZO MORENO",74,203,277
"1075","180852","EMILIO MARIA TERAN",206,1298,1504
"1076","180853","MARCOS ESPINEL (CHACATA)",435,1899,2334
"1078","180854","PRESIDENTE URBINA",974,1804,2778
"1079","180855","SAN ANDRES",1267,9924,11191
"1080","180856","SAN JOSE DE POALO",274,1605,1879
"1081","180857","SAN MIGUELITO",1163,3816,4979
"1086","180950","TISALEO",2035,8786,10821
"1085","180951","QUINCHICOTO",337,969,1306
"1125","190150","ZAMORA",7785,4692,12477
"1118","190151","CUMBARATZA",1041,3307,4348
"1120","190152","GUADALUPE",395,2450,2845
"1121","190153","IMBANA",66,1059,1125
"1122","190155","SABANILLA",11,573,584
"1124","190156","TIMBARA",75,874,949
"1123","190158","SAN CARLOS DE LAS MINAS",268,1827,2095
"1095","190250","ZUMBA",1586,5035,6621
"1090","190251","CHITO",55,1173,1228
"1091","190252","EL CHORRO",9,192,201
"1092","190254","LA CHONTA",27,234,261
"1093","190256","PUCAPAMBA",0,92,92
"1094","190259","SAN ANDRES",43,373,416
"1100","190350","GUAYZIMI",875,1695,2570
"1103","190351","ZURMI",267,1737,2004
"1102","190352","NUEVO PARAISO",28,565,593
"1112","190450","28 DE MAYO",495,2649,3144
"1113","190451","LA PAZ",69,1974,2043
"1114","190452","TUTUPALI",25,614,639
"1117","190550","YANZATZA",4308,7999,12307
"1115","190551","CHICAÑA",229,2431,2660
"1116","190553","LOS ENCUENTROS",371,3047,3418
"1097","190650","EL PANGUI",1703,3271,4974
"1096","190651","EL GUISMI",117,1487,1604
"1098","190652","PACHICUTZA",204,1082,1286
"1099","190653","TUNDAYME",90,647,737
"1089","190750","ZUMBI",1639,4768,6407
"1106","190850","PALANDA",789,2874,3663
"1104","190851","EL PORVENIR DEL CARMEN",89,1395,1484
"1107","190852","SAN FRANCISCO DE VERGEL",16,1302,1318
"1108","190853","VALLADOLID",344,885,1229
"1105","190854","LA CANELA",0,355,355
"1111","190950","PAQUISHA",350,1098,1448
"1109","190951","BELLAVISTA",11,290,301
"1110","190952","NUEVO QUITO",33,2050,2083
"1130","200150","PUERTO BAQUERIZO MORENO",3721,2435,6156
"1128","200151","EL PROGRESO",246,377,623
"1129","200152","ISLA SANTA MARIA (FLOREANA)",35,98,133
"1126","200250","PUERTO VILLAMIL",1024,965,1989
"1127","200251","TOMAS DE BERLANGA",0,164,164
"1132","200350","PUERTO AYORA",5471,5602,11073
"1131","200351","BELLAVISTA",558,1852,2410
"1133","200352","SANTA ROSA",0,485,485
"1150","210150","NUEVA LOJA",9725,47696,57421
"1146","210152","DURENO",169,2580,2749
"1148","210153","GENERAL FARFAN",576,6052,6628
"1147","210155","EL ENO",401,6228,6629
"1151","210156","PACAYACU",313,7674,7987
"1149","210157","JAMBELI",282,3015,3297
"1152","210158","STA. CECILIA",463,5790,6253
"1143","210250","LUMBAQUI",932,2110,3042
"1141","210251","EL REVENTADOR",184,1220,1404
"1142","210252","GONZALO PIZARRO",338,2557,2895
"1144","210254","PUERTO LIBRE",112,798,910
"1153","210350","PUERTO EL CARMEN DEL PUTUMAYO",705,2733,3438
"1154","210351","PALMA ROJA",108,3666,3774
"1155","210352","PUERTO BOLIVAR",0,70,70
"1156","210353","PUERTO RODRIGUEZ",0,395,395
"1158","210354","SANTA ELENA",0,1945,1945
"1163","210450","SHUSHUFINDI",4009,21524,25533
"1159","210451","LIMONCOCHA",159,5376,5535
"1160","210452","PAÑACOCHA",3,857,860
"1162","210453","SAN ROQUE",79,3039,3118
"1161","210454","SAN PEDRO DE LOS COFANES",385,2928,3313
"1164","210455","SIETE DE JULIO",560,3139,3699
"1166","210550","LA BONITA",207,604,811
"1165","210551","EL PLAYON DE SAN FRANCIS",305,1105,1410
"1167","210552","LA SOFIA",2,102,104
"1168","210553","ROSA FLORIDA",56,326,382
"1169","210554","SANTA BARBARA",147,532,679
"1134","210650","EL DORADO DE CASCALES",1178,6205,7383
"1136","210651","SANTA ROSA DE SUCUMBIOS",55,726,781
"1137","210652","SEVILLA",425,2310,2735
"1140","210750","TARAPOA",353,4366,4719
"1139","210751","CUYABENO",0,389,389
"1138","210752","AGUAS NEGRAS",8,1402,1410
"1177","220151","DAYUMA",146,5690,5836
"1187","220152","TARACOA",84,2461,2545
"1176","220153","ALEJANDRO LABAKA",21,1212,1233
"1179","220154","EL DORADO",67,1572,1639
"1180","220155","EL EDEN",6,892,898
"1181","220156","GARCIA MORENO",11,1080,1091
"1182","220157","INES ARANGO",61,2940,3001
"1183","220158","LA BELLEZA",6,4122,4128
"1184","220159","NUEVO PARAISO",66,2582,2648
"1185","220160","SAN JOSE DE GUAYUSA",69,1882,1951
"1186","220161","SAN LUIS DE ARMENIA",5,2007,2012
"1172","220250","NUEVO ROCAFUERTE",151,854,1005
"1170","220251","CAPITAN AUGUSTO RIBADENEYRA",0,701,701
"1171","220252","CONONACO",0,519,519
"1173","220253","SANTA MARIA DE HUIRIRIMA",0,729,729
"1174","220254","TIPUTINI",151,1098,1249
"1175","220255","YASUNI",0,265,265
"1189","220350","LA JOYA DE LOS SACHAS",3563,13591,17154
"1188","220351","ENOKANQUI",176,2181,2357
"1191","220352","POMPEYA",0,1204,1204
"1193","220353","SAN CARLOS",162,2684,2846
"1194","220354","SAN SEBASTIAN DEL COCA",195,3152,3347
"1190","220355","LAGO SAN PEDRO",2,1859,1861
"1083","220356","RUMIPAMBA",49,1922,1971
"1195","220357","TRES DE NOVIEMBRE",87,2920,3007
"1196","220358","UNION MILAGREÑA",124,2774,2898
"1198","220450","LORETO",1058,3069,4127
"1197","220451","AVILA",107,4223,4330
"1199","220452","PUERTO MURIALDO",21,3353,3374
"1201","220453","SAN JOSE DE PAYAMINO",10,3115,3125
"1200","220454","SAN JOSE DE DAHUANO",54,4991,5045
"1202","220455","SAN VICENTE DE HUATICOCHA",118,939,1057
"1218","230150","SANTO DOMINGO DE LOS COLORADOS",88202,216207,304409
"1208","230151","ALLURIQUIN",588,9122,9710
"1213","230152","PUERTO LIMON",676,8661,9337
"1212","230153","LUZ DE AMERICA",1186,9684,10870
"1216","230154","SAN JACINTO DEL BUA",1139,10567,11706
"1219","230155","VALLE HERMOSO",1019,8302,9321
"1211","230156","EL ESFUERZO",644,5112,5756
"1217","230157","SANTA MARIA DEL TOACHI",554,5045,5599
"1235","240150","SANTA ELENA",16987,35656,52643
"1229","240151","ATAHUALPA",811,2516,3327
"1232","240152","COLONCHE",3386,27800,31186
"1231","240153","CHANDUY",743,15608,16351
"1233","240154","MANGLARALTO",2678,26412,29090
"1236","240155","SIMON BOLIVAR",8,3288,3296
"1234","240156","SAN JOSE DE ANCON",2740,4122,6862
"1221","240250","LA LIBERTAD",31436,63758,95194
"1226","240350","SALINAS",16299,16888,33187
"1222","240351","ANCONCITO",2631,9154,11785
"1225","240352","JOSE LUIS TAMAYO",7142,14818,21960